    1   2   3   4   5
1 | 1 | 1 | 1 | 1 | 0 |
2 | X | 2 | X | 1 | 0 |
3 | 1 | 2 | 1 | 2 | 1 |
4 | 0 | 0 | 0 | 1 | X |
5 | 0 | 0 | 0 | 1 | 1 |
