    1   2   3   
1 | X | X | 1 |
2 | X | 3 | 1 |
3 | 1 | 1 | 0 |
4 | 1 | 1 | 0 |
5 | X | 1 | 0 |