    1   2   3   4  
1 | X | X | X | 1 |
2 | X | 4 | 2 | 1 |
3 | 1 | 1 | 0 | 0 |
4 | 1 | 1 | 1 | 1 |
5 | X | 1 | 1 | X |