    1   2   3   4   5   
1 | X | X | 1 | 0 | 0 |
2 | X | 3 | 1 | 1 | 1 |
3 | 1 | 1 | 0 | 1 | X |
4 | 1 | 1 | 0 | 1 | 1 |
5 | X | 1 | 0 | 0 | 0 |
